wey=where
how far=how are you
abi=isn't it
na=is
no be=is not
dem=they
una=you all
u=you
dey=are
wan=want to
fit=can
go school=attend school
sch=school
uni=university
fac=faculty
dept=department
lecturer dem=lecturers
fee=fees
money wey dem collect=fees
hostel=accommodation
room mate=roommate
course=course
subject=course
paper=exam
exam=examination
pass=pass exam
fail=fail exam
level=level
semester=semester
register=enroll
sign up=register
apply=apply
admission=admission
school fee=tuition
acceptance fee=admission fee
library=library
lecturer=lecturer
prof=professor
head of dept=head of department
hod=head of department
academic staff=lecturers
staff=staff
non academic staff=non-academic staff
technical staff=technical staff
lab=laboratory
result=results
grade=grades
carry go=proceed
make am=succeed
finish=complete
pass out=graduate
scholarship=scholarship
bursary=financial aid
book=textbook
course work=assignments
how much=how much
pay=pay
deadline=deadline
time table=schedule
lectures=classes
tutorial=tutorial
exam time=exam period
lecture hall=classroom
